Requerimiento / Puntaje

No funcionales

Autoevaluaci贸n:	Obligatorio
Lenguaje:	Obligatorio
Versi贸n:	Obligatorio
Standard:	Obligatorio
Documentaci贸n:	1
Dom->Rec:	Obligatorio
Organizaci贸n:	1
Historial:	1
Script de pruebas:	Obligatorio
Prerrequisitos:	Obligatorio

Funcionales

TDA:	0.75
Option:	1
Flow:	1
Flow-add-option:	0.75
Chatbot:	1
Chatbot-add-flow:	1
System:	1
System-add-chatbot:	1
System-add-user:	1
System-login:	0.5
System-logout:	0.5
system-talk-rec:	0
system-talk-norec:	0
system-synthesis:	0
system-simulate:	0
